"filename", "language", "Rust", "comment", "blank", "total"
"c:\Users\berys\rust\viaulence\src\game\gamestate.rs", "Rust", 4, 0, 1, 5
"c:\Users\berys\rust\viaulence\src\grid\isometric_grid.rs", "Rust", 5, 27, 4, 36
"c:\Users\berys\rust\viaulence\src\pieces.rs", "Rust", 1, 0, 0, 1
"c:\Users\berys\rust\viaulence\src\pieces\attack.rs", "Rust", 16, 17, 5, 38
"c:\Users\berys\rust\viaulence\src\pieces\movement.rs", "Rust", -492, -3, -16, -511
"c:\Users\berys\rust\viaulence\src\pieces\tokens.rs", "Rust", 181, 8, 5, 194
"c:\Users\berys\rust\viaulence\src\pieces\traits.rs", "Rust", 43, 2, 6, 51
"c:\Users\berys\rust\viaulence\src\pieces\tree.rs", "Rust", 518, 8, 19, 545
"c:\Users\berys\rust\viaulence\src\player\player.rs", "Rust", 9, 0, 1, 10
"c:\Users\berys\rust\viaulence\src\tests.rs", "Rust", 20, 2, 6, 28
"Total", "-", 305, 61, 31, 397